******************************
*                *     *     *
* ************ *** * * * *** *
*     *      * * * * *     ***
* ********** * * * * * * *** *
* *   *        *   * * * * * *
* * * ** ******* ***** * * * *
* * *      *           *     *
*   * **** *****   *** *** * *
*** *   *          * *     * *
* * *** ********   * * ***** *
*       *          *   *     *
******************************
