*************************************
*                *     *      *     *
* ************ *** * * * ***  * *   *
*     *      * * * * *     **** *  ** 
* ** ** * ** * * * * * * ***  *** ***
* *   *        *   * * * * *  * * ***
* * * **  ****** ***** * * *    *   *
* * *      *           *        *   *
*   * **** *****   *** *** *    *   *
*** *   *          * *     *    *   *
* * *** *** **** * ** * * ********  *
*       *         ****** *   *      *
*************************************
